####################################################################                                                                                                  #
|                                                                  |
|                                                                  |
|                                                                  |
|        ##########################################################|
|        <><><><><><><><><><><><><><><><><><><><><><><><><><><><><>|
|        ##########################################################|
|                                                                  |
|                                                                  |       
|                                                                  |       
|  3                                                               |       
|-----------#######<>                                              |       
|          |       <>                                              |
|                  <>#####################################<        |
|                  <><><><><><><><><><><><><><><><><><><><>        |
|                  <>#####################################<        |
|                  <>                                              |
|          |       <>   3                                          |
|          |       <>                                              |
|-----------       <>*************************************<        |
|                                                                  |
|                                                                  |
|                                                                  |
|                                                                  |
####################################################################